10
G.G.-.-.-.G.-.-.-.-
G.G.-.-.-.G.-.G.G.-
-.-.-.-.-.G.-.-.-.-
B.-.-.-.-.G.G.-.-.-
P.B.-.-.-.G.G.-.-.-
B.-.-.-.-.G.G.-.-.-
S.-.-.-.-.G.-.-.-.-
W.S.S.-.-.G.-.G.G.-
S.S.W.S.-.G.-.-.-.-
A.S.W.S.-.G.-.-.-.-