10
-.G.-.G.-.B.P.B.-.-
-.-.G.A.-.G.B.-.-.-
-.-.-.-.-.B.-.-.-.B
-.-.-.B.B.P.B.S.B.P
-.-.B.P.GB.B.S.W.S.B
-.G.-.B.-.-.G.S.-.-
-.-.-.-.-.-.S.-.-.-
G.-.G.G.-.S.W.GS.G.-
-.-.-.-.B.-.S.-.-.-
-.G.-.B.P.B.-.-.-.-
