10
-.-.G.G.-.B.-.G.G.-
-.-.-.G.B.P.B.-.-.-
-.-.G.B.-.GB.G.-.-.G
-.-.B.P.B.A.-.-.-.-
-.-.-.B.G.-.-.-.B.-
-.-.-.-.S.-.-.B.P.B
-.G.-.S.W.GS.-.B.B.P
-.-.-.-.GS.-.GB.P.B.B
-.-.-.-.-.-.-.B.B.-
G.-.-.-.-.-.-.B.P.B