10
-.-.-.-.-.-.-.-.-.-
-.-.-.G.-.-.G.-.G.G
-.-.-.-.-.-.G.A.-.-
-.G.-.G.-.-.-.-.-.-
-.-.-.-.GB.-.-.-.-.-
B.S.-.B.P.B.B.-.-.-
P.W.S.G.B.P.P.B.-.B
B.S.-.B.-.B.P.B.B.P
S.-.B.P.B.-.B.S.-.B
W.S.-.GB.-.-.S.W.S.-
