10
-.GS.-.G.B.P.B.G.-.-
S.W.S.-.-.B.-.-.-.-
B.P.B.-.B.P.B.-.-.-
-.B.-.-.G.B.-.-.-.-
-.G.-.-.-.-.B.-.-.A
-.-.-.-.-.B.P.B.-.-
-.-.-.-.-.-.B.-.-.-
-.-.-.B.-.-.B.-.G.-
G.-.B.P.B.B.P.B.-.G
-.-.G.GB.-.G.B.-.-.-
