10
-.-.-.-.-.-.B.-.B.P
G.-.-.-.-.B.P.B.B.P
-.-.GS.-.-.-.GB.-.B.P
G.S.W.S.-.-.-.-.-.B
-.-.S.-.-.-.A.-.-.-
-.-.-.-.G.G.-.G.-.-
-.-.-.-.-.-.-.-.G.-
-.-.-.-.-.-.-.-.G.-
GB.-.G.-.-.-.-.-.-.-
P.B.-.G.-.-.-.-.-.-
