10
-.-.GB.P.B.-.G.-.-.G
-.-.-.B.-.-.-.-.-.-
-.-.-.G.-.-.-.-.-.G
-.-.S.-.-.B.-.-.-.-
-.BS.W.GS.B.P.GB.G.-.-
B.P.SB.-.-.B.-.-.-.-
-.B.-.-.-.-.-.-.-.-
-.-.-.-.-.-.-.-.-.B
-.A.-.G.-.G.G.B.B.P
-.-.-.G.-.-.B.P.B.B
